111111111111111
121300010001111
101111010111111
101010010010101
100010111000101
101110000011101
101011101101001
101001000100001
100100000001001
100010101110101
100101000000101
110000101111001
101001010000001
100000000010001
111111111111111