111111111111111
120111101000111
110000001000001
101111101000101
101000100011101
100100001011111
100000111010001
111110001000001
100010001111011
100100111000001
100100001001001
100010001001101
101100111001111
110000000000031
111111111111111